"""\
               WWWWWWWWWWWWWWWWWWWWW
               WHHHHHLLLLWWLLLLLLLWW
               WHHHHHLLLLWWLLLLLLLWW
               WHHHHHLLLLWWLLLLLLLWW
               WWHHLLLLLLLWWLLLLLLLW
               WWHHLLLLLLLWWLLLLLLLW
               WWWWWWWWHWWWWLLLLLLLW
               WHHHHHHHHHWWLLLLLLWWW
               WHHHHHDDDDDLLLLLLLWWW
               WHHHHHDDDDDLLLLLLLWWW
               WHHHHHDDDDDLLLLLLLWWW
               WHHHHHDDDDDWWLLLLLWWW
               WHHHHDDDDDDLLLLWWWWWW
               WWHHHHDDDDDDLWWWWWWWW
               WWHHHHDDDDDLLLWWWWWWW
               WHHHHHDDDDDLLLLLLLWWW
               WHHHHDDDDDDLLLLWWWWWW
               WWHHHHDDDDDLLLWWWWWWW
               WWWHHHHLLLLLLLWWWWWWW
               WWWHHHHHHWWWWWWWWWWWW
               WWWWWWWWWWWWWWWWWWWWW"""